test task gradle|demo taskfreak|hello world java|testosterone|Monthly Excess Returns|Annual average sunspot area (1875-2015)|Tail Lengths of Hawks|demo
test task scheduler|demo-tasks.h|hello world c++|testicuzzi|Delay in AIDS Reporting in England and Wales|Growth rates of personal consumption and personal income in the USA.|Tail Lengths of Hawks (Unstacked)
test tasker|demo task meaning|hello world python|testicular torsion|Failures of Air-conditioning Equipment|Electricity monthly total net generation. January 1973 - June 2013.|Correctly Identified Words in a Hearing Test
test task sequence|taskray demo|hello world lyrics|testicular cancer|Failures of Air-conditioning Equipment|Quarterly visitor nights for various regions of Australia.|Heating Oil Consumption
test task c#|tasker demo|hello world song|test my internet speed|Car Speeding and Warning Signs|"Annual female murder rate (per 100|000 standard population) in the USA. 1950-2004."|Characteristics of Adirondack Hiking Trails
test task scheduler laravel|taskboard demo|hello world html|testimony|Remission Times for Acute Myelogenous Leukaemia|Aircraft Crash data|Grinnell College Basketball Games
test tasklet spring batch|taskworld demo|hello world code|testicular pain|Beaver Body Temperature Data|Chronic bronchitis in a sample of men in Cardiff|Prices of Horses
test task sequence mdt|taskfire demo|hello world onesie|testament|Population of U.S. Cities|Historical speed of light measurements|"House Prices| Sizes| and Lot Areas"
test task ant|taskfeed demo|hello world assembly|testnav|Spatial Location of Bramble Canes|"US fatal road accident data for automobiles| 1998 to 2010"|House Prices in Rural NY
test ansible task|codility demo task|hello world anime movie|test internet speed|Smoking Deaths Among Doctors|"US fatal road accident data| 2007 and 2008"|Intensive Care Unit Patients
gradle test task android|codility demo task solution|hello world austin|test cross|Calcium Uptake Data|"US fatal road accident data| 2007 and 2008"|Infant Mortality Rates
unit test task async|new nuk demo task|hello world android studio|test of lore|Sugar-cane Disease Data|Summary information on records omitted from the 'FARS' dataset|Monthly Consumer Price Index (2009-2016)
unit test async task c#|antisaccade task demo|hello world arduino|test microphone|Simulated Manufacturing Process Data|German credit scoring data|Congressional Votes on a Health Insurance Bill
skipping task ' test' as it is up-to-date|flanker task demo|hello world app|test bank|Weight Data for Domestic Cats|Global temperature anomalies|Guess IQ from a Photo?
deploy test agent task|meistertask demo|hello world android app|test synonym|Position of Muscle Caveolae|ALDH2 markers and Alcoholism|Reporting Rates for Jurors
ansible test a task|stroop task demo|hello world agency|test act|CD4 Counts for HIV-Positive Patients|APOE/APOC1 markers and Alzheimer's|Kershaw Pitch Data
what is a task test|task board demo|hello world anime op|test america|Nested Bootstrap of cd4 data|Cystic fibrosis data|Key West Water Temperatures
c# unit test a task|taskfreak demo|a hello world program in java|test automation|Channing House Data|Crohn's disease data|Body Measurements of Children
testbig task 2|task manager demo|a hello world program in python|test alternator|Population of U.S. Cities|Friedreich Ataxia data|Leafhopper Diet and Longevity
testbig task 1|n back task demo|a hello world program in c|test anxiety tips|Genetic Links to Left-handedness|A case-control data involving four SNPs with missing genotype|Leaf Measurements
tasc test book|task scheduler demo|a+ hello world|test age calculator|Number of Flaws in Cloth|The HLA data|Responses to Treatment for Leukemia
google test task bamboo|demo taskfreak|the hello world bangalore|test adobe flash|Carbon Monoxide Transfer|An example pedigree data|Levee Failures along the Mississippi River
muet speaking test task b|demo-tasks.h|the hello world coliving|test audio|Dates of Coal Mining Disasters|An example pedigree|Lewy Bodies and Dimentia
verilog test bench task|demo task meaning|the hello world collection|test aa battery with multimeter|Darwin's Plant Height Differences|A study of Parkinson's disease and MAO gene|Lewy Bodies and Dimentia with Alzheimer's
ios test background task|taskray demo|the hello world program|a testament|Cardiac Data for Domestic Dogs|A pedigree data on 282 animals deriving from two generations|Olympic Men's Long Jump Gold Medal Distance (1900 - 2008)
test false belief task|tasker demo|the hello world kota|a testoni|Incidence of Down's Syndrome in British Columbia|Example data for ACEnucfam|Olympic Men's Long Jump Gold Medal Distance (1900 - 2016)
task based test|taskboard demo|the hello world nestaway|a testable prediction is a|Behavioral and Plumage Characteristics of Hybrid Ducks|A study of Alzheimer's disease with eight SNPs and APOE|Sleep Hours for Teenagers
test celery task|taskworld demo|hello world baby|a test of faith|Counts of Balsam-fir Seedlings|"A study of Parkinson's disease and APOE| LRRK2| SNCA makers"|"Return Rates for ""Lost"" Letters"
test cron task|taskfire demo|hello world bump of chicken|a test to determine processor speed|Head Dimensions in Brothers|Growth curves of pigs in a 3x3 factorial experiment|Daily Training for a Marathon Runner
task test.com|taskfeed demo|hello world baby shower|a testable explanation of a situation|Acceleration Due to Gravity|Ordinal Data from Koch|Daily Change in Dow Jones and Nikkei Stock Market Indices
test celery task django|codility demo task|hello world being human in the age of algorithms|a testable question|Acceleration Due to Gravity|Ohio Children Wheeze Status|Enrollments in Math Courses
test control task|codility demo task solution|hello world bash script|a test in spanish|Failure Time of PET Film|Clustered Ordinal Respiratory Disorder|Math Placement Exam Results
test closure task|new nuk demo task|hello world baby outfit|a testament of youth|Jura Quartzite Azimuths on Islay|Data from a clinical trial comparing two treatments for a respiratory illness|GPA and Medical School Admission
task test class in salesforce|antisaccade task demo|hello world bump of chicken lyrics|a testimony|Average Heights of the Rio Negro river at Manaus|Epiliptic Seizures|Meniscus Repair Methods
tasc test center|flanker task demo|hello world baby girl outfit|test booster|Survival from Malignant Melanoma|Growth of Sitka Spruce Trees|Mental Health Admissions
test capistrano task|meistertask demo|hello world batch file|test boost|Data from a Simulated Motorcycle Accident|Log-size of 79 Sitka spruce trees|Metabolic Rate of Caterpillars
test task definition|stroop task demo|b'hello world'|test bench|Neurophysiological Point Process Data|"Prices of 50|000 round cut diamonds"|Commute Times
tasc test dates|task board demo|b'hello world ' tensorflow|test bank solutions|Toxicity of Nitrofen in Aquatic Systems|US economic time series|Health Services in Metropolitan Areas
test django task|taskfreak demo|b'hello world n'|test bank nursing|Nodal Involvement in Prostate Cancer|US economic time series|Migraines and TMS
task test data|task manager demo|python b'hello world'|test bandwidth|Nuclear Power Station Construction Data|2d density estimate of Old Faithful data|Ethics and a Milgram Experiment
gradle test task debug|n back task demo|b programming language hello world|test by theodore thomas|Neurotransmission in Guinea Pig Brains|'colors()' in Luv space|Standings and Team Statistics from the 2007 Baseball Season
gradle test task dsl|task scheduler demo|raspberry pi 3 b hello world|test battery|Animal Survival Times|Midwest demographics|MLB Standings in 2016
usability test task design|test camera|misha b why hello world|test blood sugar|Pole Positions of New Caledonian Laterites|Fuel economy data from 1999 and 2008 for 38 popular models of car|Moth Eggs
test task examples|test corrections|hello world code c++|b test pregnancy|Cancer Remission and Cell Activity|An updated and expanded version of the mammals sleep dataset|Effects of Serotonin in Mice
test task elixir|c testing framework|hello world code java|b test neuropsychology|Water Salinity and River Discharge|Terms of 11 presidents from Eisenhower to Obama|Estimating Time with Different Music Playing
test task epam|c tester|hello world c++ visual studio|b test.net|Survival of Rats after Radiation Doses|Vector field of seal movements|North Carolina Birth Records
test engineer task|c test if file exists|hello world company|b test pony club|Tau Particle Decay Modes|Housing sales in TX|NFL Standings for 2007 Regular Season
test execution task|c testosterone|hello world cobol|b testing service|Tuna Sighting Data|Arbuthnot's data on male and female birth ratios in London from 1629-1710.|NFL Standings for 2016 Regular Season
tasc test essay|c test and set|hello world cherry bomb|b test sarcina|Urine Analysis Data|La Felicisima Armada|Nursing Homes
gradle test task environment variables|c test function|hello world cake topper|b test nomination form|Australian Relative Wool Prices|"Bowley's data on values of British and Irish trade| 1855-1899"|Effect of Ultrasound on Oil Deapsorbtion
test task for interview|c test for empty string|c hello world program|b test pony club questions|Experimenter Expectations|Cavendish's Determinations of the Density of the Earth|Fenthion in Olive Oil
task test failed|c test for null|c hello world gcc|b test wise|American Math Society Survey Data|Chest measurements of 5738 Scottish Militiamen|Space Shuttle O-Rings
test for task|c test if directory exists|c hello world linux|b test pony club book|Moral Integration of American Cities|"William Farr's Data on Cholera in London| 1849"|Overdrawn Checking Account?
gradle test task filter|c testosteroni|c hello world windows|test connection|U. S. State Public-School Expenditures|Cushny-Peebles Data: Soporific Effects of Scopolamine Derivatives|Size of Oysters
unit test task factory startnew|test drive|c hello world tutorial|test credit card numbers|Arrests for Marijuana Possession|Cushny-Peebles Data: Soporific Effects of Scopolamine Derivatives|Palm Beach Butterfly Ballot
gradle test task failed|test drive unlimited|c hello world makefile|test calculator|Methods of Teaching Reading Comprehension|Edgeworth's counts of dactyls in Virgil's Aeneid|Monthly Peace Bridge Traffic ( 2003-2015)
unit test task.fromresult|test driven development|c hello world without stdio|test cross genetics|British Election Panel Study|Elderton and Pearson's (1910) data on drinking and wages|Monthly Peace Bridge Traffic ( 2012-2015)
vstest task failed|test definition|c hello world visual studio|test cricket|Canadian Women's Labour-Force Participation|Waite's data on Patterns in Fingerprints|Pedometer Walking Data
gradle test task force|test drive unlimited 2|c hello world with arguments|test case|Exercise Histories of Eating-Disordered and Control Subjects|Galton's data on the heights of parents and their children|Perch Sizes
gradle test task|test drive lyrics|c hello world function|test clipart|Fraudulent Data on IQs of Twins Raised Apart|"Galton's data on the heights of parents and their children| by child"|Additives in Pig Feed
ged tasc test|test drive eve of destruction|hello world docker|test camera|Canadian Population Data|"Data from A.-M. Guerry| ""Essay on the Moral Statistics of France"""|Measurements of Pine Tree Seedlings
custom test task gradle|test download speed|hello world detroit|test corrections|"2011 Canadian National Election Study| With Attitude Toward Abortion"|Halley's Life Table|Dopamine levels with PKU in diets
override test task gradle|test drive tesla|hello world dockerfile|c testing framework|Voting Intentions in the 1988 Chilean Plebiscite|W. Stanley Jevons' data on numerical discrimination|Political Behavior of College Students
create test task gradle|test day|hello world django|c tester|The 1907 Romanian Peasant Rebellion|van Langren's Data on Longitude Distance between Toledo and Rome|2008 U.S. Presidential Election Polls
add test task gradle|d test clindamycin|hello world debit card|c test if file exists|Cowles and Davis's Data on Volunteering|van Langren's Data on Longitude Distance between Toledo and Rome|Popcorn Popping Success
modify test task gradle|d test micro|hello world dr stone|c testosterone|Self-Reports of Height and Weight|"Macdonell's Data on Height and Finger Length of Criminals| used by Gosset (1908)"|Porsche and Jaguar Prices
skip test task gradle|d test explained|hello world dinosaurs|c test and set|Davis's Data on Drive for Thinness|"Macdonell's Data on Height and Finger Length of Criminals| used by Gosset (1908)"|Porsche Prices
g road test tasks|d testament books|hello world different languages|c test function|Minnesota Wolf Depredation Data|Michelson's Determinations of the Velocity of Light|Pulse Rates and Exercise
rails g task test|d test clindamycin wikipedia|hello world dll|c test for empty string|Duncan's Occupational Prestige Data|Michelson's Determinations of the Velocity of Light|Putting Success by Length (Long Form)
unit test task httpresponsemessage|d test procedure|hello world decorations|c test for null|The 1980 U.S. Census Undercount|Data from Minard's famous graphic map of Napoleon's march on Moscow|Putting Success by Length (Short Form)
vsts visual studio test task hangs|d test blood clot|d language hello world|c test if directory exists|Florida County Voting|Data from Minard's famous graphic map of Napoleon's march on Moscow|Hypothetical Putting Data (Short Form)
tasc test prep|test drive eve of destruction|hello world hackathon|f test statistic|Bivariate Data Set with 3 Clusters|Days not Spent at School|Riding with a Driver Who Has Been Drinking
test process task|test download speed|hello world how to be human in the age of the machine|f test calculator|affairs|Egyptian Skulls|Youth Risk Survey
gradle test task parameters|test drive tesla|hello world how do apples grow|f test in r|azcabgptca|Nicotine Gum and Smoking Cessation|Stand Your Ground Simpson's Paradox
airflow test task params|test day|hello world helm chart|f test formula|azdrg112|Student Risk Taking|Bladder Cancer Recurrences
gradle test task parallel|d test clindamycin|stdio.h hello world|f test excel|azpro|Crowd Baiting Behaviour and Suicides|NCCTG Lung Cancer Data
gradle test task plugin|d test micro|windows.hello world|f test vs t test|azprocedure|Toothpaste Data|Chronic Granulotamous Disease data
test task for qa|d test explained|h&m hello world|f test degrees of freedom|badhealth|House of Representatives Voting Data|Chemotherapy for Stage B/C colon cancer
test task ruby|d testament books|#include stdio.h hello world|f test regression|fasttrakg|Mortality and Water Hardness|Ddiabetic retinopathy
test rake task|d test clindamycin wikipedia|liquidcrystal_i2c.h hello world|f test p value|fishing|Water Voles Data|Assay of serum free light chain for 7874 subjects.
tasc test results|d test procedure|hello world h file|test generator|lbw|Electricity from Wave Power at Sea|Stanford Heart Transplant data
test rake task rspec|d test blood clot|hello world in c|test guide|lbwgrp|Gain in Weight of Rats|Kidney catheter data
test run task scheduler|d test statistics|hello world in java|test grader|loomis|Womens Role in Society|Acute Myelogenous Leukemia survival data
task test requirements|d test bacteria|hello world in assembly|test group|mdvis|"Observed genotype frequencies at MN and S loci| for 2 populations"|Data from the 1972-78 GSS data used by Logan
test rail task|d test positive mrsa|hello world in binary|test gif|medpar|"Mendel's F2 trifactorial data for seed shape (A: round or wrinkled)| cotyledon color (B: albumen yellow or green)| and seed coat color (C: grey-brown or white)"|NCCTG Lung Cancer Data
unit test task.run|test engineer|hello world in javascript|test graphics card|nuts|Auto Data Set|Monoclonal gammopathy data
test task sequence variables|test equipment depot|hello world in french|test gpu|rwm|The Insurance Company (TIC) Benchmark|Monoclonal gammopathy data
task test skipped|test email|hello world in r|test games|rwm1984|Sales of Child Car Seats|Acute myeloid leukemia
test scheduled task spring|testequity|hello world in go|test grade|rwm5yr|U.S. News and World Report's College Data|Data from the National Wilm's Tumor Study
tasc test scores|test engineer salary|hello world in ruby|g test canada|ships|Credit Card Balance Data|Ovarian Cancer Survival Data
task test texas|test e 300|hello world java eclipse|g test table|smoking|Credit Card Default Data|Mayo Clinic Primary Biliary Cirrhosis Data
gradle test task type|test email address|hello world jsp|g test calculator|titanic|Baseball Data|Rat treatment data from Mantel et al
visual studio test task tfs|test exchange connectivity|hello world java intellij|g test statistics|titanicgrp|NCI 60 Data|Diabetic Retinopathy
tasker test task|test eggs|hello world jar|g test in r|Aberrant Crypt Foci in Rat Colons|Orange Juice Data|rhDNASE data set
qcs test writing task tips|test every spirit|hello world jill mcdonald|g test plus|Australian athletes data set|Portfolio Data|Data from a soldering experiment
t code to test task in sap|e test interpretation|hello world jenkinsfile|g test air force|Measurements on a Selection of Books|S&P Stock Market Data|More Stanford Heart Transplant data
task test up-to-date|e test strips|hello world javafx|g test for outliers|Anesthetic Effectiveness|Mid-Atlantic Wage Data|Tobin's Tobit data
task test usability|e test online|j# hello world|g test goodness of fit|"Averages by block of corn yields| for treatment 111 only"|Weekly S&P Stock Market Data|Liver transplant waiting list
gradle test task up-to-date|e tester|bluej hello world|g test excel|Averages by block of yields for the Antigua Corn data|data from Section 1.19|Data from a trial of usrodeoxycholic acid
camunda test user task|e test mic|intellij hello world|test html|Tasting experiment that compared four apple varieties|data from Section 1.9|Projected US Population
usability test user task|e testosterone|j language hello world|test harness|Latitudes and longitudes for ten Australian cities|"data from Exercise 13.1| p418"|Veterans' Administration Lung Cancer study
sap test update task|e tester belongs to|j-wave hello world|test html code|Population figures for Australian States and Territories|"data from Exercise 4.7| p122"|Liver related laboratory data
unit test task c#|e test vancomycin|j-wave hello world 終了|test hard drive|Biomass Data|"data from Exercise 5.8| p147"|"Rain| wavesurge| portpirie and nidd datasets."
unit test task|e test personality|j-wave hello world ハリー|test headphones|"Australian and Related Historical Annual Climate Data| by region"|data from Section 1.18|"Rain| wavesurge| portpirie and nidd datasets."
test vs task|e test reading|hello world kubernetes|test hypothesis|"Australian and Related Historical Annual Climate Data| by region"|data from Section 1.14|"Rain| wavesurge| portpirie and nidd datasets."
run test task vscode|test fax|hello world kotlin|test hard drive speed|"Australian and Related Historical Annual Climate Data| by region"|data from Section 1.3|"Air pollution data| separately for summer and winter months"
unit test void task|test for m.a. seekers crossword|hello world kekkai sensen|test how fast you type|Southern Oscillation Index Data|"data from Exercise 7.7| p223"|"Rain| wavesurge| portpirie and nidd datasets."
vstest task|test for diabetes|hello world kid ink|test hair color|Southern Oscillation Index Data|data from Section 1.5|"Air pollution data| separately for summer and winter months"
vstest task github|test for ma seekers crossword clue|hello world kernel module|test hd|Boston Housing Data - Corrected|data from Section 1.6|Arthritis Treatment Data
vstest task tfs|test flight|hello world kubernetes yaml|h test eye|US Car Price Data|data from Section 1.16|Baseball Data
vstest task .net core|test for dementia|hello world kid ink lyrics|h test eye exam|A Summary of the Cars93 Data set|data from Section 1.2|Broken Marriage Data
vstest task code coverage|test for dyslexia|hello world kids|h test hamstring|Percentage of Sugar in Breakfast Cereal|"data from Exercise 7.6| p222"|Ergebnisse der Fussball-Bundesliga
vstest task dotnet core|f test table|hello world kizuna ai|h test eye muscles|Cape Fur Seal Data|data from Section 1.10|Votes in German Bundestag Election 2005
vstest task yaml|test camera|hello world kubernetes deployment yaml|h test embroidery|Populations of Major Canadian Cities (1992-96)|data from Section 1.4|Butterfly Species in Malaya
vstest task v2|test corrections|k&r hello world|h test extraocular muscles|"Dose-mortality data| for fumigation of codling moth with methyl bromide"|Data on 38 individuals using a kidney dialysis machine|Breathlessness and Wheeze in Coal Miners
vstest task vsts|c testing framework|kikki k hello world|h test calculator|Occupation and wage profiles of British cotton workers|data from Section 1.7|Danish Welfare Study Data
test windows task scheduler|c tester|k&r c hello world|h test explained|Labour Training Evaluation Data|data from Section 1.8|Employment Status
wv tasc test|c test if file exists|lazy k hello world|h test statistics|Labour Training Evaluation Data|"data from Exercise 4.4| p120"|'May' in Federalist Papers
test workflow task sap|c testosterone|brain k hello world|h test cranial nerves|Labour Training Evaluation Data|data from Section 1.13|Hitters Data
test workflow task|c test and set|hello world lambda|test internet|Lifespans of UK 1st class cricketers born 1840-1960|data from Section 1.15|Death by Horse Kicks
gradle test task with arguments|c test function|hello world lambda function|test in spanish|Comparison of cuckoo eggs with host eggs|"data from Exercise 7.13| p225"|Hospital data
ielts test writing task 1|c test for empty string|hello world lisp|test image|Cuckoo Eggs Data|data from Section 1.12|Job Satisfaction Data
ielts test writing task 2|c test for null|hello world latex|test internet connection speed|"Dengue prevalence| by administrative region"|"data from Exercise 5.6| p146"|Opinions About Joint Sports
ielts test writing task 1 examples|c test if directory exists|hello world lua|test ipv6|Dewpoint Data|data from Section 1.11|Lifeboats on the Titanic
kent test writing task|c testosteroni|hello world lambda function python|test iq|Periods Between Rain Events|"data from Exercise 7.14| p225"|Diagnosis of Multiple Sclerosis
visual studio test task xunit|test drive|hello world lyrics kid ink|test icon|EPICA Dome C Ice Core 800KYr Carbon Dioxide Data|Yield data from a Minnesota barley trial|Non-Response Survey Data
visual studio test task x64|test drive unlimited|hello world meme|test internet speed frontier|EPICA Dome C Ice Core 800KYr Temperature Estimates|Atmospheric environmental conditions in New York City|Ovary Cancer Data
xunit test task|test driven development|hello world manga|test innovators|Elastic Band Data Replicated|Engine exhaust fumes from burning ethanol|Pre-marital Sex and Divorce
ielts test task 1|test definition|hello world magazine|i testigo|Elastic Band Data Replicated Again|Melanoma skin cancer incidence|Corporal Punishment Data
writing test task 1|test drive unlimited 2|hello world matlab|i testify|Elastic Band Data|Heights of New York Choral Society singers|Repeat Victimization Data
speaking test task 1|test drive lyrics|hello world meaning|i tested positive for hpv|Fossil Fuel Data|Mortality Rates in US by Cause and Gender|Rochdale Data
ielts test task 1 writing|test drive eve of destruction|hello world my body|i tested positive for hsv 1|Female Possum Measurements|Mortality Rates in US by Cause and Gender|Families in Saxony
mock test task 1|test download speed|hello world movie anime|i test in production|Frogs Data|Arabidopsis clipping/fertilization data|Sex is Fun
ielts test task 1 academic|test drive tesla|hello world mhw|i tested positive for tb|Frosted Flakes data|Breakage Angle of Chocolate Cakes|Space Shuttle O-ring Failures
practice test task 1|test day|hello world mips|itestigo cast|Electrical Resistance of Kiwi Fruit|Contagious bovine pleuropneumonia|Suicide Rates in Germany
ielts test task 1 table|d test clindamycin|m&s hello world|i testify by ada|Effect of pentazocine on post-operative pain (average VAS scores)|Yield of dyestuff by batch|Truck Accidents Data
test 1 writing task 2|d test micro|cp/m hello world|i tested negative for herpes|Seismic Timing Data|Yield of dyestuff by batch|UK Soccer Scores
cambridge 11 test 1 task 2|d test explained|hello world node js|i tested positive for herpes|Yearly averages of Great Lake heights: 1918 - 2009|Data on red grouse ticks from Elston et al. 2001|Visual Acuity in Left and Right Eyes
cambridge 9 test 1 task 2|d testament books|hello world nyc|test java|Alcohol consumption in Australia and New Zealand|University Lecture/Instructor Evaluations by Students at ETH|Von Bortkiewicz Horse Kicks Data
cambridge 10 test 1 task 2|d test clindamycin wikipedia|hello world newborn outfit|test javascript|Minor Head Injury (Simulated) Data|Paste strength by batch and cask|Weldon's Dice Data
cambridge 8 test 1 task 2|d test procedure|hello world node|test javascript online|Minor Head Injury (Simulated) Data|Variation in penicillin testing|Women in Queues
task 1 test|d test blood clot|hello world newborn|test java code|Scottish Hill Races Data|Reaction times in a sleep deprivation study|U.S. Presidential Approval Data
cambridge 7 test 1 task 2|d test statistics|hello world nginx|test json|Scottish Hill Races Data - 2000|Verbal Aggression item responses|Sample data for bivariate probit regression
cambridge 6 test 1 task 2|d test bacteria|hello world newborn onesie|test java code online|Hawaian island chain hotspot Potassium-Argon ages|Data set for Unstructured Treatment Interruption Study|Cigarette Consumption Panel Data
ielts 10 test 1 task 2|d test positive mrsa|hello world netbeans|test javascript code|Hawaian island chain hotspot Argon-Argon ages|Determinations of Nickel Content|Coalition Dissolution in Parliamentary Democracies
ielts test task 2|test engineer|hello world nyc rental|test jpg|Aranda House Prices|Accidental Deaths in the US 1973-1978|"Coalition Dissolution in Parliamentary Democracies| Modified Version"
writing test task 2|test equipment depot|hello world node app|test json api|"Oxygen uptake versus mechanical power| for humans"|Australian AIDS Survival Data|Simulation Data for Ecological Inference
writing test task 2 ielts|test email|n-api hello world|test js|"Oxygen uptake versus mechanical power| for humans"|Brain and Body Weights for 28 Species|Freedom of Speech Data
speaking test task 2|testequity|hello world n|j test statistics|Named US Atlantic Hurricanes|Anorexia Data on Weight Change|Freedom of Speech Data
mock test task 2|test engineer salary|hello world n times haskell|j test knee|Blood pressure versus Salt; inter-population data|Presence of Bacteria after Drug Treatments|Simulated Example of Schoolchildren Friendship Network
ielts speaking test task 2|test e 300|hello world n times scala|j test econometrics|Iron Content Measurements|Body Temperature Series of Beaver 1|Simulation Data for model Seemingly Unrelated Regression (sur) that corresponds to method SUR of systemfit
ielts writing test task 2 samples|test email address|hello world n times|j test in r|Canadian Labour Force Summary Data (1995-96)|Body Temperature Series of Beaver 2|Social Security Expenditure Data
cambridge 11 test 2 task 1|test exchange connectivity|print(s'''hello nworld''')|j test usa|Kiwi Shading Data|Biopsy Data on Breast Cancer Patients|Sample Data on Home Runs Hit By Mark McGwire and Sammy Sosa in 1998.
cambridge 10 test 2 task 1|test eggs|hello world origin|j test result|Full Leaf Shape Data Set|Risk Factors Associated with Low Infant Birth Weight|Individual Preferences Over Immigration Policy
cambridge 9 test 2 task 1|test every spirit|hello world ocean life|j test mongolia|Subset of Leaf Shape Data Set|Housing Values in Suburbs of Boston|Individual Preferences Over Immigration Policy
ielts 11 test 2 task 1|e test interpretation|hello world onesie girl|j test exam|Leaf and Air Temperature Data|Data from a cabbage field trial|Individual Preferences Over Immigration Policy
book 6 test 2 task 1|e test strips|hello world onesie boy|j test indonesia|Full Leaf and Air Temperature Data Set|Colours of Eyes and Hair of People in Caithness|Individual Preferences Over Immigration Policy
cambridge 8 test 2 task 1|e test online|hello world outfit|j test nepal|Mouse Litters|Data from 93 Cars on Sale in the USA in 1993|Individual Preferences Over Immigration Policy
book 11 test 2 task 1|e tester|hello world op|test kitchen recipes|Ontario Lottery Data|Anatomical Data from Domestic Cats|Individual Preferences Over Immigration Policy
cambridge 7 test 2 task 1|e test mic|hello world of machine learning|test king|Cape Fur Seal Lung Measurements|Heat Evolved by Setting Cements|Simulation Data for model Two-Stage Least Square (twosls) that corresponds to method 2SLS of systemfit
ielts speaking test task 3|e testosterone|hello world onesie target|test keyboard|The Nine Largest Lakes in Manitoba|Copper in Wholemeal Flour|Simulation Data for model Three-Stage Least Square (threesls) that corresponds to method 3SLS of systemfit
writing test 3 task 1|e tester belongs to|hello world ocaml|test kitchen cape town|Deaths in London from measles|Co-operative Trial in Analytical Chemistry|Macroeconomic Data
reading task test 3|e test vancomycin|oh hello world|test kitchen jobs|Family Medical Expenses|Performance of Computer CPUs|Table of links for Zelig
cambridge 11 test 3 task 1|e test personality|oh hello world fanfiction|test kitchen cookbook|Mortality Outcomes for Females Suffering Myocardial Infarction|Morphological Measurements on Leptograpsus Crabs|Voting Data from the 1988 Mexican Presidental Election
cambridge 9 test 3 task 1|e test reading|hell o world water park|test keyboard keys|Darwin's Wild Mignonette Data|Diagnostic Tests on Patients with Cushing's Syndrome|Militarized Interstate Disputes
cambridge 7 test 3 task 1|test fax|o town hello world|test ketone levels|Milk Sweetness Study|DDT in Kale|The Discretized Painter's Data of de Piles
cambridge 10 test 3 task 1|test for m.a. seekers crossword|o town hello world lyrics|test kitchen south africa|Model Car Data|Monthly Deaths from Lung Diseases in the UK|Political Economic Risk Data from 62 Countries in 1987
cambridge 7 test 3 task 2|test for diabetes|oh.hello.wonderful.world tumblr|k test results|WHO Monica Data|Deaths of Car Drivers in Great Britain 1969-84|Multilateral Economic Sanctions
cambridge 8 test 3 task 1|test for ma seekers crossword clue|hello world o town music video|k test statistics|Moths Data|Foraging Ecology of Bald Eagles|Left Party Seat Share in 11 OECD Countries
cambridge 9 test 3 task 2|test flight|hello world o kompaniji|k test normal range|Airbag and other influences on accident fatalities|Seizure Counts for Epileptics|Simulated Example of Social Network Data
cambridge 10 test 4 task 2|test for dementia|jackie-o hello world|k testing laboratory inc|Documentation of names of columns in nass9702cor|Ecological Factors in Farm Management|U.S. Supreme Court Vote Matrix
ielts writing test 4 task 1|test for dyslexia|o que é hello world|k test blood|Record times for Northern Ireland mountain running events|Measurements of Forensic Glass Fragments|Swiss Fertility and Socioeconomic Indicators (1888) Data
cambridge 11 test 4 task 1|f test table|hello world python script|k restaurant|Labour Training Evaluation Data|Forbes' Data on Boiling Points in the Alps|Tobin's Tobit Data
cambridge 9 test 4 task 1|test camera|hello world program java|k restriction|Labour Training Evaluation Data|Level of GAG in Urine of Children|Turnout Data Set from the National Election Survey
cambridge 7 test 4 task 1|test corrections|hello world purdue|k restaurant near me|Labour Training Evaluation Data|Velocities for 82 Galaxies|Sample Turnout and Demographic Data from the 2000 Current Population Survey
cambridge 8 test 4 task 1|c testing framework|hello world program in python|k restaurant names|A Subset of the nsw74psid1 Data Set|Remission Times of Leukaemia Patients|1932 Weimar election data
gradle 4 test task|c tester|hello world powershell|k restaurant moorea|Labour Training Evaluation Data|Rat Genotype Data|Table of links for Zelig
test 4 writing task 1 book 10|c test if file exists|hello world python 3|test light|Labour Training Evaluation Data|Old Faithful Geyser Data|
celpip speaking test task 5|c testosterone|p hello world /p|test ldap connection|Measurements on 12 books|Line Transect of Soil in Gilgai Territory|
cambridge 12 test 5 task 1|c test and set|char *p = hello world|test leads|Challenger O-rings Data|Record Times in Scottish Hill Races|
ielts 12 test 5 task 2|c test function|hello world p&o cruises|test light bulb|Ozone Data|Frequency Table from a Copenhagen Housing Conditions Survey|
cambridge 12 test 5 task 2|c test for empty string|hello world quotes|test link|Heated Elastic Bands|Yields from a Barley Field Trial|
ielts 12 test 5 task 1|c test for null|hello world qt|test latency|Possum Measurements|Numbers of Car Insurance claims|
gradle 5 test task|c test if directory exists|hello world qr code|test laptop camera|Possum Sites|Survival Times and White Blood Counts for Leukaemia Patients|
cambridge 5 test 2 task 2|c testosteroni|hello world quiz|test lead kit|"Deaths from various causes| in London from 1629 till 1881| with gaps"|Brain and Body Weights for 62 Species of Land Mammals|
book 5 test 2 task 2|test drive|hello world qt5|test lan speed|Primate Body and Brain Weights|Data from a Simulated Motorcycle Accident|
cambridge 12 test 6 task 1|test drive unlimited|hello world qml|test laptop battery|"Progression of Record times for track races| 1912 - 2008"|Survival from Malignant Melanoma|
cambridge 12 test 6 task 2|test driven development|hello world quantum computer|l test amputee|Labour Training Evaluation Data|Age of Menarche in Warsaw|
test 6 writing task 1|test definition|hello world queenstown|l test of functional mobility|Labour Training Evaluation Data|Michelson's Speed of Light Data|
book 6 test 1 task 1|test drive unlimited 2|hello world qantas|l test agility|Labour Training Evaluation Data|Minnesota High School Graduates of 1938|
cambridge 6 test 1 task 1|test drive lyrics|hello world queensland deals|l testicular pain icd 10|Scottish Hill Races Data - 2000|Accelerated Life Testing of Motorettes|
celpip speaking test task 7|test drive eve of destruction|hello world react|l test icbc|Rainforest Data|Effect of Calcium Chloride on Muscle Contraction in Rat Hearts|
cambridge 12 test 7 task 1|test download speed|hello world rentals|l test booking|Rare and Endangered Plant Species|Newcomb's Measurements of the Passage Time of Light|
task 7 test 3|test drive tesla|hello world roblox id|l test qld|Genetically Modified and Wild Type Rice Data|Eighth-Grade Pupils in the Netherlands|
test 7 writing task 2|test day|hello world ruby|l test sa|Pacific Rock Art features|"Classical N| P| K Factorial Experiment"|
cambridge 7 test 1 task 1|d test clindamycin|hello world rust|l test vic|Lawn Roller Data|US Naval Petroleum Reserve No. 1 data|
book 7 test 1 task 1|d test micro|hello world robot|test my wifi speed|School Science Survey Data|Data from an Oats Field Trial|
celpip speaking test task 8|d test explained|hello world react native|test master|Barley Seeding Rate Data|Tests of Auditory Perception in Children with OME|
cambridge 12 test 8 task 1|d testament books|hello world roblox game|test maker|Social Support Data|The Painter's Data of de Piles|
cambridge 12 test 8 task 2|d test clindamycin wikipedia|hello world release date|test meme|Measurements on a Selection of Paperback Books|N. L. Prater's Petrol Refinery Data|
task 8 test 4|d test procedure|r hello world function|test my ping|sorption data set|Belgium Phone Calls 1950-1973|
test 8 writing task 2|d test blood clot|r hello world sql server|test marketing|Closing Numbers for S and P 500 Index|Diabetes in Pima Indian Women|
test 8 writing task 1|d test statistics|r hello world code|test my typing speed|Closing Numbers for S and P 500 Index - First 100 Days of 1990|Diabetes in Pima Indian Women|
cambridge 8 test 1 task 1|d test bacteria|r hello world package|m test houston|Spam E-mail Data|Diabetes in Pima Indian Women|
cambridge 8 test 2 task 2|d test positive mrsa|r hello world text file|m testosterone|Averages by block of yields for the St. Vincent Corn data|Absenteeism from School in Rural New South Wales|
cambridge 9 test 1 task 1|test engineer|r language hello world|m test cel|Sugar Data|Blood Pressure in Rabbits|
ielts 9 test 3 task 1|test equipment depot|r print hello world|m tester|Car Window Tinting Experiment Data|Road Accident Deaths in US States|
book 9 test 1 task 1|test email|hello world rstudio|m restaurant|Root weights of tomato plants exposed to 4 different treatments|Numbers of Rotifers by Fluid Density|
cambridge 9 test 2 task 2|testequity|r shiny hello world|m testa|Toy Cars Data|Accelerated Testing of Tyre Rubber|
1 testosterone results|test engineer salary|hello world svg|m test reviews|"Averages by block of corn yields| for treatment 111 only"|Ships Damage Data|
test 250|test e 300|hello world spring boot|m test 7|Video Lottery Terminal Data|"Shoe wear data of Box| Hunter and Hunter"|
test 200|test email address|hello world song robot|m testosterone booster|Wages of Lancashire Cotton Factory Workers in 1833|Percentage of Shrimp in Shrimp Cocktail|
test 2a ap statistics answers|test exchange connectivity|hello world scala|m test for autism|"Deaths from whooping cough| in London"|Space Shuttle Autolander Problem|
test 2 sat|test eggs|hello world solar system|test network speed|"Record times for track and road races| at August 9th 2006"|Growth Curves for Sitka Spruce Trees in 1988|
test 220 outlet|test every spirit|hello world sweepstakes|test nwea|Ability and Intelligence Tests|Growth Curves for Sitka Spruce Trees in 1989|
test 2b ap statistics answers|e test interpretation|char *s = hello world|test network|"Passenger Miles on Commercial US Airlines| 1937-1960"|AFM Compositions of Aphyric Skye Lavas|
test 2 baby|e test strips|string s = hello world|test now|Monthly Airline Passenger Numbers 1949-1960|Snail Mortality Data|
test 23|e test online|printf( s hello world )|testng|New York Air Quality Measurements|Returns of the Standard and Poors 500|
test 250 cycle|e tester|hello world this is me|test ntp server|Anscombe's Quartet of 'Identical' Simple Linear Regressions|The Saturated Steam Pressure Data|
test 2 sat answers|e test mic|hello world tiger woods|test negative|The Joyner-Boore Attenuation Data|The Stormer Viscometer Data|
2 test plug|e testosterone|hello world tattoo|test nat type|The Chatterjee-Price Attitude Data|Student Survey Data|
2 test ball|e tester belongs to|hello world this is me life should be|test nginx config|Quarterly Time Series of the Number of Australian Residents|Synthetic Classification Problem|
2 testosterone cream|e test vancomycin|hello world travel|n test 600|Sales Data with Leading Indicator|Synthetic Classification Problem|
2 test ball plug|e test personality|hello world typescript|n test trial|Biochemical Oxygen Demand|Spatial Topographic Data|
2 test tee|e test reading|hello world t shirt|n test 600 advanced|Speed and Stopping Distances of Cars|Effect of Swedish Speed Limits on Accidents|
2 testosterone|test fax|hello world trailer|n test tips|Weight versus age of chicks on different diets|Nutritional and Marketing Information on US Cereals|
2 test cap|test for m.a. seekers crossword|hello world tensorflow|n test cost|Chicken Weights by Feed Type|The Effect of Punishment Regimes on Crime Rates|
2 test and drain|test for diabetes|hello world tutorial|n tester|Mauna Loa Atmospheric CO2 Concentration|Veteran's Administration Lung Cancer Trial|
2 test tb test|test for ma seekers crossword clue|at&t hello world|n test tool|Carbon Dioxide Uptake in Grass Plants|Counts of Waders at 15 Sites in South Africa|
2 testosterone gel|test flight|t sql hello world|n test tips icbc|Student's 3000 Criminals Data|House Insulation: Whiteside's Data|
test 300|test for dementia|t shirt hello world|n test reddit|Yearly Numbers of Important Discoveries|Weight Loss Data from an Obese Patient|
test 3d print|test for dyslexia|at&t assembly hello world|n tester price|Elisa assay of DNase|Example Data for the Design Functions|
test 3 sat answers|f test table|uint8_t data = hello world|test of strength|"Smoking| Alcohol and (O)esophageal Cancer"|Example Data for the Crossover Encouragement Design|
test 350|test camera|hello world ukulele|test optional colleges|Conversion Rates of Euro Currencies|"Brader| Valentino and Suhay (2008) Framing Experiment Data"|
test 3a ap statistics|test corrections|hello world us release|test of strength wow|"Daily Closing Prices of Major European Stock Indices| 1991-1998"|JOBS II data|
test 360|c testing framework|hello world unity|test of skulls|Old Faithful Geyser Data|School-level data|
test 3 phase motor|c tester|hello world unix|test optional colleges in pa|Determination of Formaldehyde|Hypothetical student-level data|
test 3b ap statistics|c test if file exists|hello world usa|test of endurance|Freeny's Revenue Data|Subset of variables from the CHAIN project|
test 300 steroids|c testosterone|hello world using reactjs|test of lore classic|Hair and Eye Color of Statistics Students|National Longitudinal Survey of Youth Extract|
test 3 way switch|c test and set|hello world unix script|test of righteousness|Harman Example 2.3|Alcohol Consumption per Capita|
3 test plug|c test function|hello world using spring boot|o testamento do senhor napumoceno|Harman Example 7.4|US Births in 1969 - 1988|
3 test ball|c test for empty string|hello world university city|no tests found for given includes|Pharmacokinetics of Indomethacin|US Births|
3 testis|c test for null|hello world url|no testosterone|Infertility after Spontaneous and Induced Abortion|US Births in 2015|
3 test oxo|c test if directory exists|u boot hello world|no tests were found intellij|Effectiveness of Insect Sprays|US Births in 1978|
3 test tee|c testosteroni|u-boot hello_world.bin|no tests found matching method|Edgar Anderson's Iris Data|Standard Deck of Cards|
3 test taking strategies|test drive|u-boot hello world.c|no test is available in|Edgar Anderson's Iris Data|CoolingWater|
3 testable questions|test drive unlimited|u-sql hello world|no tests found exiting with code 1|Areas of the World's Major Landmasses|Countries|
3 test tubes|test driven development|u-boot example hello world|no tests found to run|Quarterly Earnings per Johnson & Johnson Share|Data from the 1985 Current Population Survey (CPS85)|
3 test pipe|test definition|u boot run hello_world|no tests found for given includes gradle|Level of Lake Huron 1875-1972|Weight of dimes|
3 test for cdl|test drive unlimited 2|hello world visual studio|no tests found matching|Luteinizing Hormone in Blood Samples|Galton's dataset of parent and child heights|
test 400|test drive lyrics|hello world visual studio code|test print|Intercountry Life-Cycle Savings Data|Data from the Child Health and Development Studies|
test 4k|test drive eve of destruction|hello world video|test prep|Growth of Loblolly pine trees|Goose Permit Study|
test 473|test download speed|hello world visual basic|test pdf|Longley's Economic Regression Data|Data from a heat exchanger laboratory|
test 400 dosage|test drive tesla|hello world vba|test plan|Annual Canadian Lynx trappings 1821-1934|Health Evaluation and Linkage to Primary Care|
test 450|test day|hello world visual studio code c++|test print page|Michelson Speed of Light Data|Health Evaluation and Linkage to Primary Care|
test 400 stack|d test clindamycin|hello world vbscript|test pattern|Motor Trend Car Road Tests|Health Evaluation and Linkage to Primary Care|
test 4g speed|d test micro|hello world virus|test proctor|Average Yearly Temperatures in New Haven|Foot measurements in children|
test 4 sat answers|d test explained|hello world vue|test plan template|Flow of the River Nile|Marriage records|
test 4k sx-7 revolution|d testament books|hello world vscode|test ping|"Average Monthly Temperatures at Nottingham| 1920-1939"|Mites and Wilt Disease|
test 4k monitor|d test clindamycin wikipedia|risc v hello world|test prep usa|"Classical N| P| K Factorial Experiment"|Volume of Users of a Rail Trail|
4 test plug|d test procedure|altera cyclone v hello world|p test calculus|Occupational Status of Fathers and their Sons|Volume of Users of a Massachusetts Rail Trail|
4 test ball|d test blood clot|hello_world.v|p test calculator|Growth of Orange Trees|Houses in Saratoga County (2006)|
4 test asvab|d test statistics|hello world website|p test statistics|Potency of Orchard Sprays|State by State SAT data|
4 testosterone killing foods|d test bacteria|hello world wine|p test convergence|Results from an Experiment on Plant Growth|"Snowfall data for Grand Rapids| MI"|
4 test ged|d test positive mrsa|hello world weather|p test vs t test|Annual Precipitation in US Cities|100 m Swimming World Records|
4 tests of highest and best use|test engineer|hello world wallpaper|p test excel|Quarterly Approval Ratings of US Presidents|Cherry Blossom Race|
4 test tee|test equipment depot|hello world wiki|p test series|Vapor Pressure of Mercury as a Function of Temperature|Utility bills|
4 test for cdl|test email|hello world war|p test integral|Reaction Velocity of an Enzymatic Reaction|Utility bills|
4 test asvab practice|testequity|hello world web page|p test formula|Locations of Earthquakes off Fiji|Weather|
4 test cap|test engineer salary|hello world wine red midi dress|p test for goats|Random Numbers from Congruential Generator RANDU|Data from the Whickham survey|
test 500|test e 300|hello world war file|test questions|Lengths of Major North American Rivers|Rheumatoid Arthritis Clinical Trial|
test 5 sat answers|test email address|hello world walkies|test qr code|Measurements on Petroleum Rock Samples|Homeless Data|
test 5.1|test exchange connectivity|hello world w assembler|test quotes|Road Casualties in Great Britain 1969-84|Cigarette Consumption|
test 5 love languages|test eggs|hello world w c|test quiz|Student's Sleep Data|Crime in North Carolina|
test 50 hunting|test every spirit|hello world w różnych językach|test question generator|Brownlee's Stack Loss Plant Data|Employment and Wages in the United Kingdom|
test 50 states|e test interpretation|hello world w pythonie|test questions and answers|"Monthly Sunspot Data| from 1749 to ""Present"""|Gasoline Consumption|
test 5 scoring|e test strips|hello world w python|test quizlet|"Yearly Sunspot Data| 1700-1988"|Grunfeld's Investment Data|
test 5 pin relay|e test online|hello world w html|test quest|"Monthly Sunspot Numbers| 1749-1983"|Hedonic Prices of Census Tracts in the Boston Area|
test 50 colorado|e tester|hello world w asemblerze|test question types|Swiss Fertility and Socioeconomic Indicators (1888) Data|Wages and Hours Worked|
test 5g speed|e test mic|hello world w java|test question bank|Pharmacokinetics of Theophylline|Wages and Education of Young Males|
5 testosterone cream|e testosterone|hello world w javie|q test calculator|Survival of passengers on the Titanic|Purchasing Power Parity and other parity relationships|
5 test taking strategies|e tester belongs to|hello world xcode|q test chart|The Effect of Vitamin C on Tooth Growth in Guinea Pigs|US States Production|
5 testable questions|e test vancomycin|hello world xml|q test software|"Yearly Treering Data| -6000-1979"|Production of Rice in Indonesia|
5 test plug|e test personality|hello world xamarin|q test alcohol|"Girth| Height and Volume for Black Cherry Trees"|Employment and Wages in Spain|
5 testable science questions|e test reading|hello world x86 assembly|q test tool|Student Admissions at UC Berkeley|"The Penn World Table| v. 5"|
5 tests for stroke|test fax|hello world x86|q tester|Road Casualties in Great Britain 1969-84|Panel Data of Individual Wages|
5 test taking tips|test for m.a. seekers crossword|hello world xcode c++|q test for heterogeneity|UK Quarterly Gas Consumption|Yearly batting records for all major league baseball players|
5 test for qualifying child|test for diabetes|hello world xcode 11|q test urine test|Accidental Deaths in the US 1973-1978|Monthly ozone measurements over Central America.|
5 tests of a fixture|test for ma seekers crossword clue|hello world xilinx sdk|q test ovulation|Violent Crime Rates by US State|Absentee and Machine Ballots in Pennsylvania State Senate Races|
5 tests for extraterrestrial life|test flight|hello world xhtml|q test adhd|Lawyers' Ratings of State Judges in the US Superior Court|Applications to a Political Science PhD Program|
test 600|test for dementia|hello world x86_64 assembly|test retest reliability|Personal Expenditure Data|"Political opinion polls in Australia| 2004-07"|
test 600x|test for dyslexia|x# hello world|test results|Populations Recorded by the US Census|"elections to Australian House of Representatives| 1949-2016"|
test 600 advanced|f test table|vert.x hello world|testrail|Death Rates in Virginia (1940)|article production by graduate students in biochemistry Ph.D. programs|
test 6 sat answers|test camera|mplab x hello world|test run|Topographic Information on Auckland's Maunga Whau Volcano|California Congressional Districts in 2006|
test 600 advanced side effects|test corrections|jenkins x hello world|test regex|The Number of Breaks in Yarn during Weaving|"Batting Averages for 18 major league baseball players| 1970"|
test 600x side effects|c testing framework|x window hello world|test review|Average Heights and Weights for American Women|"U.S. Senate vote on the use of force against Iraq| 2002."|
test 66|c tester|vert.x hello world java|test reliability|The World's Telephones|political parties appearing in the U.S. Congress|
test 600 pmd|c test if file exists|vert.x hello world example|test routing number|Internet Usage per Minute|Interviewer ratings of respondent levels of political information|
test 6 scoring|c testosterone|activex hello world|test ram|Acifluorfen and diquat tested on Lemna minor.|"elections for U.S. President| 1932-2016| by state"|
test 600 reviews|c test and set|x-plane plugin hello world|test reaction time|Volume of algae as function of increasing concentrations of a herbicide|Prussian army horse kick data|
6 test ball|c test function|hello world youtube|r test for normality|Effect of technical grade and commercially formulated auxin herbicides|"Voter turnout experiment| using Rock The Vote ads"|
6 test plug|c test for empty string|hello world yaml|r testthat|Germination of common chickweed (_Stellaria media_)|information about the American states needed for U.S. Congress|
6 test tubes|c test for null|hello world yaml file|r test statistic|Germination of common chickweed (_Stellaria media_)|1992 United Kingdom electoral returns|
6 test ball plug|c test if directory exists|hello world yaml kubernetes|r test train split|Daphnia test|cross national rates of trade union density|
6 test cap|c testosteroni|hello world youtube convention|r test correlation|Performance of decontaminants used in the culturing of a micro-organism|Reports of voting in the 1992 U.S. Presidential election.|
6 test kitchen|test drive|hello world yo gabba gabba|r test if string contains|Deguelin applied to chrysanthemum aphis|16 ability items scored as correct or incorrect.|
6 test tee|test drive unlimited|hello world yesterday|r test if file exists|Earthworm toxicity test|Two data sets of affect and arousal scores as a function of personality and movie conditions|
6 test taking strategies|test driven development|hello world youtube channel|r test for na|Effect of erythromycin on mixed sewage microorganisms|Seven data sets showing a bifactor solution.|
6 test ashes series|test definition|hello world yarrawonga|r test for equal variance|Example from Finney (1971)|Seven data sets showing a bifactor solution.|
6 tests of planning conditions|test drive unlimited 2|hello world yahoo|r test if null|Herbicide applied to Galium aparine|Seven data sets showing a bifactor solution.|
test 7 sat answers|test drive lyrics|hello world zpl|test speed|Germination of three crops|25 Personality items representing 5 factors|
test 7.1 surround|test drive eve of destruction|hello world zug|test statistic|Glyphosate and metsulfuron-methyl tested on algae.|25 Personality items representing 5 factors|
test 7.1|test download speed|hello world zoe sugg|test strips|Mortality of tobacco budworms|A 29 x 29 matrix that produces weird factor analytic results|
test 7 sat scoring|test drive tesla|z turn hello world|test statistic calculator|Heart rate baroreflexes for rabbits|Bond's Logical Operations Test - BLOT|
test 7 dpo|test day|z/os assembler hello world|test search|Leaf length of barley|11 emotional variables from Burt (1915)|
test 71 torpedo|d test clindamycin|z/os c hello world|test sound|Dose-response profile of degradation of agrochemical using lepidium|12 cognitive variables from Cattell (1963)|
test 7.1 headphones|d test micro|z/os cobol hello world|test statistic formula|Hormesis in lettuce plants|Distances between 11 US cities|
test 7.1 surround sound|d test explained|java z os hello world|test strips for money|Effect of an effluent on the growth of mysid shrimp|Galton's example of the relationship between height and 'cubit' or forearm length|
test 7 drivers ed|d testament books|hello world z/os|test scores|Mechlorprop and terbythylazine tested on Lemna minor|"A data set from Cushny and Peebles (1905) on the effect of three drugs on hours of sleep| used by Student (1908)"|
test 7.3 injectors|d test clindamycin wikipedia|hello_world 0.elf|s test statistics|Data from heavy metal mixture experiments|8 cognitive variables used by Dwyer for an example.|
7 tests of just cause|d test procedure|hello world in 0 1|s testosterone|Weight gain for different methionine sources|Eysenck Personality Inventory (EPI) data for 3570 participants|
7 testing principles|d test blood clot|db hello world 0x0a|s testo|Dose-response profile of degradation of agrochemical using nasturtium|13 personality scales from the Eysenck Personality Inventory and Big 5 inventory|
7 tests for material participation|d test statistics|hello world day 0|s testing service|Test data from a 21 day fish test|Eysenck Personality Inventory (EPI) data for 3570 participants|
7 testosterone killers|d test bacteria|msg db 'hello world ' 0xa|s testosterone free|Effect of sodium pentachlorophenate on growth of fathead minnow|Eysenck Personality Inventory (EPI) data for 3570 participants|
7 tests for 70 beaumont|d test positive mrsa|string db hello world 0x0a|s testosterone test price|Competition between two biotypes|Galton's Mid parent child height data|
7 tests just cause arbitration|test engineer|hello world trackid=sp-006|s testo blood test|Effect of ferulic acid on growth of ryegrass|"Example data from Gleser| Cronbach and Rajaratnam (1965) to show basic principles of generalizability theory."|
7 test of true love|test equipment depot|print( hello world end= 0 )|s testimonials|Potency of two herbicides|Example data set from Gorsuch (1997) for an example factor extension.|
7 tests for mineral identification|test email|db 'hello world' 10 0|s testosterone test in hindi|Effect of cadmium on growth of green alga|Five data sets from Harman (1967). 9 cognitive variables from Holzinger and 8 emotional variables from Burt|
7 tests to identify minerals|testequity|hello world 0バイト|tesla s|Root length measurements|Five data sets from Harman (1967). 9 cognitive variables from Holzinger and 8 emotional variables from Burt|
7 testaments|test engineer salary|day 0 hello world. solution in c|test tube holder|Data from toxicology experiments with selenium|Five data sets from Harman (1967). 9 cognitive variables from Holzinger and 8 emotional variables from Burt|
test 800 number|test e 300|day 0 hello world|test tube rack|Inhibition of photosynthesis|A data.frame of the Galton (1888) height and cubit data set.|
test 8 answers|test email address|day 0 hello world hackerrank solution|test track|The effect of terbuthylazin on growth rate|Seven data sets showing a bifactor solution.|
test 8 scoring|test exchange connectivity|day 0 hello world. solution|test tube clamp|Vinclozolin from AR in vitro assay|Seven data sets showing a bifactor solution.|
test 8 managing time and space|test eggs|day 0 hello world javascript|test tube brush|Ship Accidents|US family income from US census 2008|
test 888 number|test every spirit|day 0 hello world hackerrank solution javascript|test track park|Cost for U.S. Airlines|16 multiple choice IQ items|
test 8n coil|e test interpretation|day 0 hello world. solution in java|t test calculator|Air Quality for Californian Metropolitan Areas|75 mood items from the Motivational State Questionnaire for 3896 participants|
test 8-3 mystatlab final examination|e test strips|hello world 10|t test formula|Countries in Banking Crises|75 mood items from the Motivational State Questionnaire for 3032 unique participants|
test 802.1x authentication|e test online|hello world 10 times java|t test table|Unemployment of Blue Collar Workers|NEO correlation matrix from the NEO_PI_R manual|
test 8.8.8.8|e tester|hello world 19th main|t test excel|Bids Received By U.S. Firms|Galton's Peas|
8 test plug|e test mic|hello world 19th main hsr|t test in r|Cyber Security Breaches|Seven data sets showing a bifactor solution.|
8 test ball|e testosterone|hello world 16x2|t test statistics|Budget Share of Food for Spanish Households|State Anxiety data from the PMC lab over multiple occasions.|
8 test cap|e tester belongs to|hello world 100 languages|t test assumptions|Budget Shares for Italian Households|State Anxiety data from the PMC lab over multiple occasions.|
8 test ball plug|e test vancomycin|hello world 11|t test vs z test|Budget Shares of British Households|"3 Measures of ability: SATV| SATQ| ACT"|
8 testosterone boosting foods|e test personality|hello world 123|t test p value|Wages in Belgium|12 variables created by Schmid and Leiman to show the Schmid-Leiman Transformation|
8 tests to identify a mineral|e test reading|1_hello_world|t test vs anova|Stock Market Data|The Schutz correlation matrix example from Shapiro and ten Berge|
8 testo|test fax|angular 1 hello world|test upload speed|Stated Preferences for Car Choice|A sample from the SAPA Personality Inventory including an item dictionary and scoring keys.|
8 tests for special causes|test for m.a. seekers crossword|struts 1 hello world example|test ufo|The California Test Score Data Set|A sample from the SAPA Personality Inventory including an item dictionary and scoring keys.|
8 test in driving|test for diabetes|magento 1 hello world module|test udp port|Choice of Brand for Catsup|State Anxiety data from the PMC lab over multiple occasions.|
8.test çöz|test for ma seekers crossword clue|function 1 - hello world|test url|Cigarette Consumption|Data set testing causal direction in presumed media influence|
test 911|test flight|level 1 hello world of xss|test upload download speed|The Cigarette Consumption Panel Data Set|Data set testing causal direction in presumed media influence|
test 9v battery|test for dementia|struts 1 hello world example in eclipse|test user|Sales Data of Men's Fashion Stores|Seven data sets showing a bifactor solution.|
test 911 call|test for dyslexia|pl/1 hello world|test usb speed|Prices of Personal Computers|Seven data sets showing a bifactor solution.|
test 9 answers|f test table|apple 1 hello world|test udp connection|Quarterly Data on Consumption and Expenditure|Seven data sets showing a bifactor solution.|
test 9dpo|test camera|struts 1 hello world|test used to measure flexibility|Earnings from the Current Population Survey|9 Cognitive variables discussed by Tucker and Lewis (1973)|
test 9 scoring|test corrections|hello world 2019|test uncertainty ratio|Choice of Brand for Crakers|An example of the distinction between within group and between group correlations|
test 955|c testing framework|hello world 2019 purdue|u test vs t test|Growth of CRAN|Barro Data|
test 911 address|c tester|hello world 2019 anime|u test statistics|Crime in North Carolina|Boscovich Data|
9 testimony|c test if file exists|hello world 2 gif|u test in r|Daily Returns from the CRSP Database|Cobar Ore data|
9 test personality|c testosterone|hello world 2 ffxiv|u test calculator|Monthly Returns from the CRSP Database|Engel Data|
9 testosterone level|c test and set|hello world 2018|utest o meter|Pricing the C's of Diamond Stones|Time Series of US Gasoline Prices|
9 testosterone friendly fruits|c test function|hello world 2017|u test python|DM Dollar Exchange Rate|Garland(1983) Data on Running Speed of Mammals|
9 test paper|c test for empty string|hello world 2020|u testament|Number of Doctor Visits|UIS Drug Treatment study data|
9 tests of organisation design|c test for null|hello world 2.0|utest drug test|Doctor Visits in Australia|Sensory data from a french fries experiment.|
9 tests of scorpio|c test if directory exists|hello world 2019 download|u test matlab|Contacts With Medical Doctor|Demo data describing the Smiths.|
9 tests of a wife|c testosteroni|angular 2 hello world|u test instructions|Earnings for Three Age Groups|Tipping data|
9 test screening battery|test drive|python 2 hello world|test video|Cost Function for Electricity Producers|Aircraft Data|
9 test playing nations|test drive unlimited|magento 2 hello world module|test validity|Extramarital Affairs Data|Air Quality Data|
testequity|test driven development|struts 2 hello world example|test version crossword clue|Drunk Driving Laws and Traffic Deaths|Alcohol Solubility in Water Data|
test engineer salary|test definition|angular 2 hello world example|test vpn|Choice of Fishing Mode|Daily Means of NOx (mono-nitrogen oxides) in air|
test e 300|test drive unlimited 2|angular 2 hello world step by step|test variable|Exchange Rates of US Dollar Against Other Currencies|Brain and Body Weights for 65 Species of Land Animals|
test email address|test drive lyrics|magento 2 hello world|test visa card|Data from the Television Game Show Friend Or Foe ?|Biomass Tillage Data|
test exchange connectivity|test drive eve of destruction|tensorflow 2 hello world|test video camera|Daily Observations on Exchange Rates of the US Dollar Against Other Currencies|Campbell Bushfire Data|
test eggs|test download speed|struts 2 hello world|test volume|Gasoline Consumption|Insect Damages on Carrots|
test every spirit|test drive tesla|angular 2 hello world jsfiddle|test video download|Wage Datas|Cloud point of a Liquid|
e test interpretation|test day|hello world 3.0 vit|test version|Grunfeld Investment Data|Coleman Data Set|
e test strips|d test clindamycin|hello world 3d print|v testaverde|Heating and Cooling System Choice in Newly Built Houses in California|Condroz Data|
e test online|d test micro|hello world 30s|v testaverde jr|The Boston HMDA Data Set|Crohn's Disease Adverse Events Data|
e tester|d test explained|hello world 3149|vtestify|Heating System Choice in California Houses|Cushny and Peebles Prolongation of Sleep Data|
e test mic|d testament books|hello world python 3.7|v test statistics|Hedonic Prices of Census Tracts in Boston|Delivery Time Data|
e testosterone|d test clindamycin wikipedia|hello world python 3 script|v testaverde tampa bay buccaneers|Cybersecurity breaches reported to the US Department of Health and Human Services|Education Expenditure Data|
e tester belongs to|d test procedure|hello world python 3.6|v test studio|Health Insurance and Hours Worked By Wives|Epilepsy Attacks Data Set|
e test vancomycin|d test blood clot|hello happy world 3rd single|v tester|The Boston HMDA Data Set|Example Data of Antille and May - for Simple Regression|
e test personality|d test statistics|hello world ionic 3|v testulat champagne brut|Sales Prices of Houses in the City of Windsor|Food Stamp Program Participation|
e test reading|d test bacteria|python 3 hello world|v testing process is|Housing Starts|"Hawkins| Bradu| Kass's Artificial Data"|
test fax|d test positive mrsa|python 3 hello world example|v testicularis|Ice Cream Consumption|Heart Catherization Data|
test for m.a. seekers crossword|test engineer|phaser 3 hello world|test webcam|Global Terrorism Database yearly summaries|Waterflow Measurements of Kootenay River in Libby and Newgate|
test for diabetes|test equipment depot|ionic 3 hello world|test wwe|Income Inequality in the US|Lactic Acid Concentration Measurement Data|
test for ma seekers crossword clue|test email|shapeoko 3 hello world|test website|Seasonally Unadjusted Quarterly Data on Disposable Income and Expenditure|Length of Stay Data|
test flight|testequity|spring 3 hello world example|test wrestler|Monthly Interest Rates|Daudin's Milk Composition Data|
test for dementia|test engineer salary|polymer 3 hello world|test water heater element|Economic Journals Dat Set|NOx Air Pollution Data|
test for dyslexia|test e 300|python 3 hello world main|test wifi signal|Willingness to Pay for the Preservation of the Kakadu National Park|Pension Funds Data|
f test table|test email address|python 3 hello world script|test website speed|Choice of Brand for Ketchup|Phosphorus Content Data|
d test bacteria|test exchange connectivity|joomla 3 hello world component|test water heater thermostat|Klein's Model I|Pilot-Plant Data|
d test positive mrsa|test eggs|hello world angular 4|test wifi connection|Wages and Hours Worked|Possum Diversity Data|
test engineer|test every spirit|hello world swift 4|w test championship points table|Belgian Firms|Pulp Fiber and Paper Data|
test equipment depot|e test interpretation|flask hello world 404|w test for normality|The Longley Data|Satellite Radar Image Data from near Munich|
test email|e test strips|hello world ionic 4|w test championship|Dollar Sterling Exchange Rate|Salinity Data|
testequity|e test online|hello world bootstrap 4|w testamencie|Macroeconomic Time Series for the United States|Siegel's Exact Fit Example Data|
test engineer salary|e tester|print hello world 4 times in python|w testamencie krzyżówka|Wages and Education of Young Males|Hertzsprung-Russell Diagram Data of Star Cluster CYG OB1|
test e 300|e test mic|hello world angular 4 example|w testamencie zapis|Manufacturing Costs|Steam Usage Data (Excerpt)|
test email address|e testosterone|hello happy world 4th single|w testamencie to legat|Level of Calculus Attained for Students Taking Advanced Micro-economics|Number of International Calls from Belgium|
test exchange connectivity|e tester belongs to|hello world radio 4|test w.b.c|The Massachusetts Test Score Data Set|Toxicity of Carboxylic Acids Data|
test eggs|e test vancomycin|hello world issue 4|w&g test|Structure of Demand for Medical Care|Vaso Constriction Skin Data Set|
test every spirit|e test personality|angular 4 hello world|testosteron w tabletkach|Production for SIC 33|Wagner's Hannover Employment Growth Data|
e test interpretation|e test reading|spring 4 hello world example|test xfinity speed|Inflation and Interest Rates|Modified Data on Wood Specific Gravity|
e test strips|test fax|angular 4 hello world example|test xml|Mode Choice|Automobile Data from 'Consumer Reports' 1990|
e test online|test for m.a. seekers crossword|bootstrap 4 hello world|test x180 reviews|Data to Study Travel Mode Choice|Automobile Data from 'Consumer Reports' 1990|
e tester|test for diabetes|ionic 4 hello world|test xpath|"International Expansion of U.S. Mofa's (majority-owned Foreign Affiliates in Fire (finance| Insurance and Real Estate)"|Automobile Data from 'Consumer Reports' 1990|
e test mic|test for ma seekers crossword clue|swift 4 hello world|test xbox controller on pc|"Money| GDP and Interest Rate in Canada"|Data on Children who have had Corrective Spinal Surgery|
e testosterone|test flight|spring 4 hello world example with annotations|test xml file|Macroeconomic Series for the United States|Soldering of Components on Printed-Circuit Boards|
e tester belongs to|test for dementia|angular 4 hello world github|x testada|"Money| National Product and Interest Rate"|Stage C Prostate Cancer|
e test vancomycin|test for dyslexia|spring 4 hello world|x test adhd|Labor Supply Data|Innovation and Institutional Ownership|
e test personality|f test table|mule 4 hello world|x testo|Municipal Expenditure Data|US Investment Data|
e test reading|test camera|hello world 5 mile|x test statistics|Growth of Disposable Income and Treasury Bill Rate|Petersen's Simulated Data for Assessing Clustered Standard Errors|
test fax|test corrections|html5 hello world|x testada simbolo|Willingness to Pay for the Preservation of the Alentejo Natural Park|US Expenditures for Public Schools|
test for m.a. seekers crossword|c testing framework|hello world angular 5|x test table|"Cost Function for Electricity Producers| 1955"|Bollen's Data on Industrialization and Political Democracy|
test for diabetes|c tester|print hello world 5 times in python|x testada word|Global Terrorism Database yearly summaries|Variables from the 1997 Canadian National Election Study|
test for ma seekers crossword clue|c test if file exists|print hello world 5 times in c|x testada en excel|Names with Character Set Problems|Klein's Data on the U. S. Economy|
test flight|c testosterone|print hello world 5 times|x test y test|Visits to Physician Office|Partly Artificial Data on the U. S. Economy|
test for dementia|c test and set|hello world laravel 5.5|x testosterone|Oil Investment|Six Mental Tests|
test for dyslexia|c test function|hello world in 5 languages|test your internet speed|The Orange Juice Data Set|Prices of Used Honda Accords (in 2017)|
f test table|c test for empty string|hello world laravel 5|test your iq|Labor Force Participation|Congressional Votes on American Health Care Act (in 2017)|
f test statistic|c test for null|hello happy world 5th single|test your typing speed|Dynamic Relation Between Patents and R&D|Ontime Records for Two Airlines at Two Airports|
f test calculator|c test if directory exists|angular 5 hello world|test your metal|"Patents| R&D and Technological Spillovers for a Panel of Firms"|Alfalfa Growth|
f test in r|c testosteroni|spring 5 hello world example|test your mettle|Price and Earnings Index|US Senate Votes on Samuel Alito for the Supreme Court|
f test formula|test drive|angular 5 hello world example|test your knowledge|Political knowledge in the US and Europe|Amyloid-beta and Cognitive Impairment|
f test excel|test drive unlimited|qt 5 hello world|test your intolerance|Pound-dollar Exchange Rate|Daily Price and Volume of Apple Stock|
f test vs t test|test driven development|spring 5 hello world|test your love|Exchange Rates and Price Indices for France and Italy|Scores in an Archery Class|
f test degrees of freedom|test definition|junit 5 hello world|test your intolerance reviews|Returns of Size-based Portfolios|"Athletic Participation| Race| and Graduation"|
f test regression|test drive unlimited 2|printf(5+ hello world )|test your mic|Us States Production|Reaction Times to Audio and Visual Stimuli|
f test p value|test drive lyrics|mvc 5 hello world example c#|y test dna|Panel Survey of Income Dynamics|Noise Levels of Filters to Reduce Automobile Pollution|
test generator|test drive eve of destruction|swift 5 hello world|y test balance|Return to Schooling|Weights of College Student Backpacks|
test guide|test download speed|hello world 6502|y test acl|Wages and Schooling|Baseball Game Times of One Day in 2008|
test grader|test drive tesla|hello world 6502 assembly|y tostada|Solow's Technological Change Data|Baseball Game Times of One Day in 2017|
test group|test day|hello world 68k|y test kit|Visits to Lake Somerville|Do Bee Stings Depend on Previous Stings?|
test gif|d test clindamycin|hello world 64-bit assembly|y testis pain|Returns on Standard & Poor's 500 Index|Effect of a Hormone on Bird Calcium Levels|
test graphics card|d test micro|hello world angular 6|y test scoring|Effects on Learning of Small Class Sizes|Nest Characteristics for Different Bird Species|
test gpu|d test explained|hello world nasm 64 bit|y testada|Strike Duration Data|"Blood Pressure| Weight| and Smoking Status"|
test games|d testament books|hello world commodore 64|y teste fisioterapia|Strikes Duration|Blue Jay Measurements|
test grade|d test clindamycin wikipedia|hello world issue 6|y teste como fazer|Number of Strikes in Us Manufacturing|Brain pH Measurements|
g test canada|d test procedure|hello world assembly x64|test zoom|The Penn Table|Drew Brees Passing Statistics (2016)|
g test table|d test blood clot|angular 6 hello world|test zip file|"Interest Rate| GDP and Inflation"|Attitudes Towards British Trade Unions|
g test calculator|d test statistics|angular 6 hello world example|test zener diode|Global Terrorism Database yearly summaries|Butterfly (Boloria chariclea) Measurements|
g test statistics|d test bacteria|angular 6 hello world github|test zoom audio|Households Tobacco Budget Share|US Senate Votes on Corporate Average Fuel Economy Bill|
g test in r|d test positive mrsa|perl 6 hello world|test zone|Stated Preferences for Train Traveling|Do Calcium Supplements Lower Blood Pressure?|
g test plus|test engineer|angularjs 6 hello world|test zodiac|Statewide Data on Transportation Equipment Manufacturing|Canadian Drugs Senate Vote|
g test air force|test equipment depot|jbpm 6 hello world example|test za trudnocu|Evaluating Treatment Effect of Training on Earnings|Survival Times for Different Cancers|
g test for outliers|test email|angular 6 hello world size|test zinc levels|Choice of Brand for Tuna|Measurements of Manduca Sexta Caterpillars|
g test goodness of fit|testequity|angular 6 hello world application|test zip file download|Unemployment Duration|Cleveland Cavalier's Shooting (2016-2017)|
g test excel|test engineer salary|angular 6 hello world project|test zoom mic|Unemployment Duration|Nutrition Content of Breakfast Cereals|
test html|test e 300|spartan 6 hello world|z test calculator|Provision of University Teaching and Research|THC for Antinausea Treatment in Chemotherapy|
test harness|test email address|hello world 771 jailbreak|z test formula|Official Secrecy of the United States Government|Age at First Speaking|
test html code|test exchange connectivity|hello world angular 7|z test vs t test|US Finance Industry Profits|Clinton/Sanders Primary Results (2016)|
test hard drive|test eggs|hello world php 7|z test statistic|US GDP per capita with presidents and wars|Sales for a Clothing Retailer|
test headphones|test every spirit|hello world channel 7|z test statistic calculator|Standard abbreviations for states of the United States|Cloud Seeding Experiment (Winter Only)|
test hypothesis|e test interpretation|hello world jboss 7|z test table|Number of Words in US Tax Law|Cloud Seeding Experiment (Four Seasons)|
test hard drive speed|e test strips|hello world issue 7|z test excel|Medical Expenses in Viet-nam (household Level)|Daily CO2 Measurements in Germany|
test how fast you type|e test online|hello world itext 7|z test example|Medical Expenses in Viet-nam (individual Level)|Daily CO2 Measurements in Germany|
test hair color|e tester|hello world atmel studio 7|z test in r|Panel Datas of Individual Wages|CO2 Readings in Hawaii|
test hd|e test mic|angular 7 hello world|z test statistic formula|"Wages| Experience and Schooling"|CO2 Readings at the South Pole|
h test eye|e testosterone|php 7 hello world|test 02 sensor|Wife Working Hours|Drug Interaction with Contraceptives|
h test eye exam|e tester belongs to|angular 7 hello world example|test 02 sensor heater circuit|Yen-dollar Exchange Rate|County Health Resources|
h test hamstring|e test vancomycin|drupal 7 hello world module|test 02 sensor with multimeter|Choice of Brand for Yogurts|Crab Oxygen Intake|
h test eye muscles|e test personality|itext 7 hello world|test 0800 number|Daily Log Returns on BMW Share Price|Effects of Cracker Fiber on Digested Calories|
h test embroidery|e test reading|angular 7 hello world github|test 000|Danish Fire Insurance Claims|Overdrawn Checking Account?|
h test extraocular muscles|test fax|liferay 7 hello world portlet|test $07 data fail|The River Nidd Data|Measurements of Cuckoo Eggs|
h test calculator|test for m.a. seekers crossword|angular 7 hello world program|test 02|The River Nidd Data|First Day Survey of Statistics Students|
h test explained|test for diabetes|angular 7 hello world size|test 0nline|Daily Log Returns on Siemens Share Price|Lactic Acid Turnover in Dogs|
h test statistics|test for ma seekers crossword clue|jbpm 7 hello world|0 test classes found in package|SP Data to June 1993|Characteristics of a Sample of Diamonds|
h test cranial nerves|test flight|hello world 8086|0 testosterone|SP Return Data to October 1987|Characteristics of a Subset of the Diamond Sample|
test internet|test for dementia|hello world assembly 8086|0 testosterone level|Australian monthly gas production|Iridium Levels in Rock Layers to Investigate Dinosaur Extinction|
test in spanish|test for dyslexia|hello world angular 8|0 testosterone in a woman|Daily morning gold prices|2008 U.S. Presidential Election|
test image|f test table|hello world drupal 8 module|0 testo nitro|Half-hourly electricity demand|2016 U.S. Presidential Election|
test internet connection speed|test camera|hello world java 8|0 tests found visual studio|Australian total wine sales|Measurements of Male African Elephants|
test ipv6|test corrections|hello world drupal 8|*#0*# test|Quarterly production of woollen yarn in Australia|Measurements of African Elephants|
test iq|c testing framework|hello world masm 8086|0 tests completed karma|Monthly anti-diabetic drug sales in Australia from 1991 to 2008.|Effects of Oxygen on Sugar Metabolism|
test icon|c tester|hello world asm 8086|0 tests run visual studio|International Arrivals to Australia|Pupil Dilation and Sexual Orientation|
test internet speed frontier|c test if file exists|hello world emu8086|testarossa 0-60|Air Transport Passengers Australia|Facial Attractiveness of Men|
test innovators|c testosterone|hello world utf-8|test 123|Quarterly Australian Beer production|Faithfulness from a Photo?|
i testigo|c test and set|drupal 8 hello world module|test 1700|Monthly expenditure on eating out in Australia|Selection Times in a Fantasy Baseball Draft|
i testify|c test function|angular 8 hello world|test 10|International visitors to Australia|Diet and Weight of Rats|
i tested positive for hpv|c test for empty string|java 8 hello world|test 12v battery|International Tourists to Australia: Total visitor nights.|Fertility Data for Women Having Trouble Getting Pregnant|
i tested positive for hsv 1|c test for null|angular 8 hello world example|test 144hz|Call volume for a large North American bank|Results of NFL Field Goal Attempts|
i test in production|c test if directory exists|java 8 hello world example|test 1a ap statistics answers|Retail debit card usage in Iceland.|Film Data from Leonard Maltin's Guide|
i tested positive for tb|c testosteroni|drupal 8 hello world|test 1b ap statistics answers|Total monthly departures from Australia|NCAA Final Four by Seed and Tom Izzo (through 2010)|
itestigo cast|test drive|java 8 hello world lambda|test 12v battery with multimeter|"Half-hourly and daily electricity demand for Victoria| Australia| in 2014"|NCAA Final Four by Seed and Tom Izzo (through 2017)|
i testify by ada|test drive unlimited|pico 8 hello world|test 180x|"Half-hourly and daily electricity demand for Victoria| Australia| in 2014"|NCAA Final Four by Seed (Long Version through 2010)|
i tested negative for herpes|test driven development|tomcat 8 hello world|1 testosterone|Electrical equipment manufactured in the Euro area.|NCAA Final Four by Seed (Long Version through 2017)|
i tested positive for herpes|test definition|drupal 8 hello world module download|1 test cyp|Electricity sales to residential customers in South Australia.|CAA Final Four by Seed (Short Version through 2010)|
test java|test drive unlimited 2|hello world channel 9|1 testosterone gel|Quarterly retail trade: Euro area.|NCAA Final Four by Seed (Short Version through 2017)|
test javascript|test drive lyrics|hello world fortran 90|1 test plug|US finished motor gasoline product supplied.|Finger Tap Rates|
test javascript online|test drive eve of destruction|hello world fortran 95|1 testosterone side effects|Daily closing stock prices of Google Inc|First Year GPA for College Students|
test java code|test download speed|hello world xcode 9|1 testosterone cycle|Daily closing stock prices of Google Inc|Fertility of Fish Eggs|
test json|test drive tesla|hello world java 9|1 testosterone cream|Rice production (Guinea)|Body Measurements of Mammal Species|
test java code online|test day|hello world ch 9|1 testosterone stack|Monthly corticosteroid drug sales in Australia from July 1991 to June 2008.|Response of Migratory Geese to Helicopter Overflights|
test javascript code|d test clindamycin|hello world xcode 9.2|1 testicle dog|Daily pageviews for the Hyndsight blog. 30 April 2014 to 29 April 2015.|Florida Death Penalty Cases|
test jpg|d test micro|hello world mpi fortran 90|j test nepal|Insurance quotations and advertising expenditure.|Measuring Calcium Binding to Proteins|
test json api|d test explained|hello world program fortran 90|test kitchen recipes|"Livestock (sheep) in Asia| 1961-2007."|Finger Tap Rates|
test js|d testament books|java 9 hello world|test king|Boston marathon winning times since 1897|Fruit Fly Sexual Activity and Longevity|
j test statistics|d test clindamycin wikipedia|channel 9 hello world|test keyboard|"Maximum annual temperatures at Moorabbin Airport| Melbourne"|Fruit Fly Sexual Activity and Male Competition|
j test knee|d test procedure|xcode 9 hello world|test kitchen cape town|"Total weekly air passenger numbers on Ansett airline flights between Melbourne and Sydney| 1987-1992."|Funnel Drop Times|
j test econometrics|d test blood clot|java 9 hello world example|test kitchen jobs|Winning times in Olympic men's 400m track final. 1896-2016.|Female Glow-worms|
j test in r|d test statistics|tomcat 9 hello world|test kitchen cookbook|Annual oil production in Saudi Arabia|Goldenrod Galls|
j test usa|d test bacteria|directx 9 hello world|test keyboard keys|prison|"House Sales in Grinnell| Iowa"|
j test result|d test positive mrsa|java 9 hello world module|test ketone levels|prison|Grocery Sales and Discounts|
j test mongolia|test engineer|cloud 9 hello world|test kitchen south africa|Quarterly Australian Electricity production|Are Gunnels Present at Shoreline?|
j test exam|test equipment depot|xcode 9 hello world objective c|k test results|Quarterly Australian Portland Cement production|Guess Author's Sex from Handwriting?|
j test indonesia|test email|9 now hello world|k test statistics|Quarterly Australian Gas Production|Measurements on Three Hawk Species|
